1111111111111111
1000000C00000111
1010111110000111
1010000C0000P111
101000000000E111
1001111101100001
1111111111111111